...#....#.
.....#....
..#..#....
..........
.......##.
....#.....
....#.....
.##.#..#..
..........
.###..####

